Region,Epiweek,Epiweek - Start Date,Total Tests,Total Positive Tests,Proportion of VoC,Total VoC,Total Non-VoC
British Columbia,1,2021-01-03,55859,3837,0,0,3837
Fraser,1,2021-01-03,27079,2113,0,0,2113
Interior,1,2021-01-03,5214,424,0,0,424
Northern,1,2021-01-03,2269,368,0,0,368
Vancouver Coastal,1,2021-01-03,16035,788,0,0,788
Island,1,2021-01-03,5262,144,0,0,144
British Columbia,2,2021-01-10,57092,3386,0.4,14,3372
Fraser,2,2021-01-10,26307,1550,1,16,1534
Interior,2,2021-01-10,6581,605,0,0,605
Northern,2,2021-01-10,2169,334,0,0,334
Vancouver Coastal,2,2021-01-10,16398,739,0,0,739
Island,2,2021-01-10,5637,158,0,0,158
British Columbia,3,2021-01-17,60956,3459,1.1,38,3421
Fraser,3,2021-01-17,28000,1618,2,32,1586
Interior,3,2021-01-17,6519,552,0,0,552
Northern,3,2021-01-17,2185,300,0,0,300
Vancouver Coastal,3,2021-01-17,18741,804,0,0,804
Island,3,2021-01-17,5511,185,0,0,185
British Columbia,4,2021-01-24,62585,3319,1,33,3286
Fraser,4,2021-01-24,27823,1451,1.2,17,1434
Interior,4,2021-01-24,7014,489,0,0,489
Northern,4,2021-01-24,2178,283,0,0,283
Vancouver Coastal,4,2021-01-24,19177,880,4.1,36,844
Island,4,2021-01-24,6393,216,0,0,216
British Columbia,5,2021-01-31,51986,3120,1.1,34,3086
Fraser,5,2021-01-31,23392,1536,1.8,28,1508
Interior,5,2021-01-31,6531,399,0,0,399
Northern,5,2021-01-31,2052,309,0,0,309
Vancouver Coastal,5,2021-01-31,13505,673,3.8,26,647
Island,5,2021-01-31,6506,203,0,0,203
British Columbia,6,2021-02-07,49864,3116,2.4,75,3041
Fraser,6,2021-02-07,23055,1670,3.5,58,1612
Interior,6,2021-02-07,5720,274,0,0,274
Northern,6,2021-02-07,2184,297,0,0,297
Vancouver Coastal,6,2021-02-07,13357,752,1.5,11,741
Island,6,2021-02-07,5548,123,3.6,4,119
British Columbia,7,2021-02-14,50640,3456,3.7,128,3328
Fraser,7,2021-02-14,24008,1949,5.1,99,1850
Interior,7,2021-02-14,4795,199,2.6,5,194
Northern,7,2021-02-14,2208,293,0,0,293
Vancouver Coastal,7,2021-02-14,13825,821,2.8,23,798
Island,7,2021-02-14,5804,194,0,0,194
British Columbia,8,2021-02-21,57253,3625,6.9,250,3375
Fraser,8,2021-02-21,27250,2067,8.9,184,1883
Interior,8,2021-02-21,5470,227,3.4,8,219
Northern,8,2021-02-21,2205,232,0.5,1,231
Vancouver Coastal,8,2021-02-21,15890,867,6.5,56,811
Island,8,2021-02-21,6438,232,0,0,232
British Columbia,9,2021-02-28,59428,3847,11.5,442,3405
Fraser,9,2021-02-28,28528,2142,14.8,317,1825
Interior,9,2021-02-28,5129,204,7.1,14,190
Northern,9,2021-02-28,2264,290,0,0,290
Vancouver Coastal,9,2021-02-28,17022,1025,10.4,107,918
Island,9,2021-02-28,6485,186,0.5,1,185
British Columbia,10,2021-03-07,58517,3855,16.2,625,3230
Fraser,10,2021-03-07,29096,2214,19.8,438,1776
Interior,10,2021-03-07,5620,226,6.2,14,212
Northern,10,2021-03-07,2205,306,1.4,4,302
Vancouver Coastal,10,2021-03-07,16369,960,16.9,162,798
Island,10,2021-03-07,5227,149,3.4,5,144
British Columbia,11,2021-03-14,56408,4154,26.2,1088,3066
Fraser,11,2021-03-14,28360,2461,31.3,770,1691
Interior,11,2021-03-14,4433,171,18.9,32,139
Northern,11,2021-03-14,2258,340,0.9,3,337
Vancouver Coastal,11,2021-03-14,16110,1101,25.3,279,822
Island,11,2021-03-14,5247,81,4.9,4,77
British Columbia,12,2021-03-21,58888,5705,38.3,2185,3520
Fraser,12,2021-03-21,28659,2974,40.5,1204,1770
Interior,12,2021-03-21,4925,309,37.2,115,194
Northern,12,2021-03-21,2116,329,4.3,14,315
Vancouver Coastal,12,2021-03-21,17344,1809,44.9,812,997
Island,12,2021-03-21,5844,284,13.3,38,246
British Columbia,13,2021-03-28,67526,7019,51.6,3622,3397
Fraser,13,2021-03-28,30415,3504,54.9,1924,1580
Interior,13,2021-03-28,7460,484,42.9,208,276
Northern,13,2021-03-28,1854,332,6.2,21,311
Vancouver Coastal,13,2021-03-28,20530,2285,58.7,1341,944
Island,13,2021-03-28,7267,414,28.7,119,295
British Columbia,14,2021-04-04,78734,8179,66,5398,2781
Fraser,14,2021-04-04,37691,4484,68.1,3054,1430
Interior,14,2021-04-04,8738,729,58.1,424,305
Northern,14,2021-04-04,2058,302,17,51,251
Vancouver Coastal,14,2021-04-04,21402,2249,74,1664,585
Island,14,2021-04-04,8845,415,46.7,194,221
British Columbia,15,2021-04-11,76458,7260,70.8,5140,2120
Fraser,15,2021-04-11,38624,4306,72.8,3135,1171
Interior,15,2021-04-11,8578,589,66.2,390,199
Northern,15,2021-04-11,2161,269,22.3,60,209
Vancouver Coastal,15,2021-04-11,19370,1809,75.6,1368,441
Island,15,2021-04-11,7725,287,68.8,197,90
British Columbia,16,2021-04-18,69541,6434,76.4,4916,1518
Fraser,16,2021-04-18,36498,4133,76.1,3145,988
Interior,16,2021-04-18,7604,434,81.7,355,79
Northern,16,2021-04-18,1929,224,32.9,74,150
Vancouver Coastal,16,2021-04-18,18147,1422,82.9,1179,243
Island,16,2021-04-18,5363,221,79.9,177,44
British Columbia,17,2021-04-25,69191,5554,78.9,4382,1172
Fraser,17,2021-04-25,35685,3680,78.7,2896,784
Interior,17,2021-04-25,7714,377,79.5,300,77
Northern,17,2021-04-25,1928,168,30.2,51,117
Vancouver Coastal,17,2021-04-25,17516,1148,86.9,998,150
Island,17,2021-04-25,6348,181,77.2,140,41
British Columbia,18,2021-05-02,62664,4624,82.9,3833,791
Fraser,18,2021-05-02,32651,3136,81.7,2562,574
Interior,18,2021-05-02,6975,326,83,271,55
Northern,18,2021-05-02,1804,124,47.6,59,65
Vancouver Coastal,18,2021-05-02,15890,907,92.4,838,69
Island,18,2021-05-02,5344,131,82.8,108,23
British Columbia,19,2021-05-09,55140,3757,84.3,3167,590
Fraser,19,2021-05-09,28504,2421,82.1,1988,433
Interior,19,2021-05-09,6042,307,87.2,268,39
Northern,19,2021-05-09,1500,109,59.8,65,44
Vancouver Coastal,19,2021-05-09,14561,837,93.7,784,53
Island,19,2021-05-09,4533,83,76.7,64,19
British Columbia,20,2021-05-16,48934,2885,83.9,2421,464
Fraser,20,2021-05-16,24443,1808,81.7,1477,331
Interior,20,2021-05-16,5424,333,88,293,40
Northern,20,2021-05-16,1644,142,65.7,93,49
Vancouver Coastal,20,2021-05-16,13152,527,92,485,42
Island,20,2021-05-16,4271,75,89.9,67,8
British Columbia,21,2021-05-23,41720,2092,84.7,1772,320
Fraser,21,2021-05-23,20198,1187,81,961,226
Interior,21,2021-05-23,5084,302,93.8,283,19
Northern,21,2021-05-23,1363,81,85,69,12
Vancouver Coastal,21,2021-05-23,11101,479,93,445,34
Island,21,2021-05-23,3974,43,61,26,17
